XXXXXXXXXXXXXXXXXXXXXXXXXXXXXX
X             +               
X &&&&&&& &&& & &&&& &&&&&&&&X
X       +   & &&&            X
X& &&&& &&&&&&& &&&&+&&&&&&&&X
X  &  &         +     &      X
X&&&& &&&&&&& &&&&&&&&&&&&&&+X
X           & +              X
X&&&&&& && &&&& &&&&&&&&&&&& X
X     +  &          &      & X
X&&&& &&&&&&&&&&&&+&&&&&+&&& X
X     &   &         &     &  X
X&& &&& & & &&&&&&& & &&&&& &X
X       &         &          X
X XXXXXXXXXXXXXXXXXXXXXXXXXXXX
